NO ./textures/BRICK_3B.xpm
SO ./textures/BRICK_3D.xpm
WE ./textures/BRICK_6D.xpm
EA ./textures/CRATE_2C.xpm

F 60,120,70
C 0,0,32

    11111111111111
        111E001001
    111111100011111
    10000000111111
    1010000111 101
    10100001 11111
    10100001
    10100001
    10100001
    11111111
