SO ./textures/wall_south.xpm
NO ./textures/wall_north.xpm
WE ./textures/wall_west.xpm
EA ./textures/wall_east.xpm

F 116,4,20
C 135,206,235

        1111111111111111111111111
        1000000000110000000000001
        1011000001110000000000001
        100100S000000000000000001
111111111011000001110000000000001
100000000011000001110111111111111
11110111111111011100000010001
11110111111111011101010010001
11000000110101011100000010001
10000000000000001100000010001
10000000000000001101010000001
1100000111010101111101111000111
11110111 1110101 101111010001
11111111 1111111 111111111111
